alias ls='ls -G'
alias ..='cd ..'
alias desk='cd ~/Desktop'
alias docs='cd ~/Documents'
alias bp='atom ~/.bash_profile'
alias a.='atom .'

alias be='bundle exec'
alias bi='bundle install'
alias rspec='bundle exec rspec'
alias ww='webpack --watch'
alias gcm='git commit -m'
alias gaa='git add -A'
alias gb='git branch'
alias gc='git clone'
alias gch='git checkout'
alias gcb='git checkout -b'
alias master='git checkout master'
alias merge='git merge'
alias gs='git status'
alias gpo='git push -u origin master'
alias gph='git push heroku master'
alias rdbm='bundle exec rake db:migrate'
alias rdbc='bundle exec rake db:create'
alias rdbs='bundle exec rake db:seed'
alias rdbmt='bundle exec rake db:migrate db:test:load'
alias hr='heroku run'
alias hrrdmb='heroku run rake db:migrate'
alias hrrdbs='heroku run rake db:seed'
alias hrrc='heroku run rails console'
alias rr='bundle exec rake routes'
alias rc='rails console'
alias rs='rails server'
